1111111111111
100100000P0C1
1000011111C01
1P0011EC00001
1111111111111