1111111
1000001
1C11101
1P1E001
1111111