1111111
1000001
1C11101
1P1E0Y1
1111111