1111011111111
10010000000C1
1000011111C01
1P0011EC00001
1111111111111