11111111111111111111
1P001C001000100000C1
11101110111011101111
10001000000000000001
10111011101110111001
100000100010001C0001
11110011101110111111
1C0001100000010000E1
10111011111101110101
10001000000000000001
111011101C0110101111
11111111111111111111